2222222222222222222222222222222222222222222222222222222222222222222222222222222222222222222222222222
2155511111111111111111111111111111111111111111111111111111111111111111111121111111111111111111101152
2111411111111111111111111111111111611111111111111111111111111111111111111121111111111111111111111152
2111111111111111111111111111111111111111111111111111111111111111111411111121111111111116111111111152
2111111111111161111111111111111111111111111111111111111111111111111111111121111111111111111111111112
2111111111111111111111114111111111111111111111111111111111111111111111111131111111111111111111111112
2111122222222222222222333322222222222222222222222221111111111111111111111131111111111111111111111112
2111111111111111111111411111111111111111511111111111111111111111111111111131111111111111114111111112
2111111111111111111111111111111111111111111111111111111111111111111111111131111161111111111111111112
2111141111111111111111111111111111111161111111111111111111111111111111111121111111111111111111111112
2111111111111111111111111111111111111111111111111111111111111111111111111121111111111111111111111112
2111111111111116111111111411111111111111111114111111111111116111111111111122222222233322221111111112
2111111111111111111111111111111111111111111111111111111111111111111111111121111111111111121114111112
2111122222223333332222222222222222222222222222222221111111111611111111111121111111111111121111111112
2511111111111111111111111111111111111111111111111111111111111111111111111121114111111115521111111112
2222222222222222222222222222222222222222222222222222222222222222222222222222222222222222222222222222